askai = "zcmds.cmds.common.askai:main"
aicode = "zcmds.cmds.common.aicode:main"
imgai = "zcmds.cmds.common.imgai:main"
img2webp = "zcmds.cmds.common.img2webp:main"
zcmds = "zcmds.cmds.common.zcmds_main:main"
audnorm = "zcmds.cmds.common.audnorm:main"
codeup = "zcmds.cmds.common.codeup:main"
comports = "zcmds.cmds.common.comports:main"
diskaudit = "zcmds.cmds.common.diskaudit:main"
findfiles = "zcmds.cmds.common.findfiles:main"
gitsummary = "zcmds.cmds.common.gitsummary:main"
obs_organize = "zcmds.cmds.common.obs_organize:main"
printenv = "zcmds.cmds.common.printenv:main"
pdf2png = "zcmds.cmds.common.pdf2png:main"
pdf2txt = "zcmds.cmds.common.pdf2txt:main"
search_and_replace = "zcmds.cmds.common.search_and_replace:main"
search_in_files = "zcmds.cmds.common.search_in_files:main"
sharedir = "zcmds.cmds.common.sharedir:main"
stereo2mono = "zcmds.cmds.common.stereo2mono:main"
gitconfig = "zcmds.cmd.common.gitconfig:main"
img2vid = "zcmds.cmds.common.img2vid:main"
vidmute = "zcmds.cmds.common.vidmute:main"
vidinfo = "zcmds.cmds.common.vidinfo:main"
vid2gif = "zcmds.cmds.common.vid2gif:main"
vid2jpg = "zcmds.cmds.common.vid2jpg:main"
vid2mp3 = "zcmds.cmds.common.vid2mp3:main"
vid2mp4 = "zcmds.cmds.common.vid2mp4:main"
vid2webm = "zcmds.cmds.common.vid2webm:main"
vidclip = "zcmds.cmds.common.vidclip:main"
viddur = "zcmds.cmds.common.viddur:main"
vidspeed = "zcmds.cmds.common.vidspeed:main"
vidvol = "zcmds.cmds.common.vidvol:main"
vidshrink = "zcmds.cmds.common.vidshrink:main"
vidmatrix = "zcmds.cmds.common.vidmatrix:main"
vidwebmaster = "zcmds.cmds.common.vidwebmaster:main"
vidhero = "zcmds.cmds.common.vidhero:main"
vidlist = "zcmds.cmds.common.vidlist:main"
test_net_connection = "zcmds.cmds.darwin.test_net_connection:main"
fixinternet = "zcmds.cmds.common.fixinternet:main"
whichall = "zcmds.cmds.common.whichall:main"
geninvoice = "zcmds.cmds.common.geninvoice:main"
say = "zcmds.cmds.common.say:main"
vidcat = "zcmds.cmds.common.vidcat:main"
myip = "zcmds.cmds.common.myip:main"
losslesscut = "zcmds.cmds.common.losslesscut:main"
archive = "zcmds.cmds.common.archive:main"
imgshrink = "zcmds.cmds.common.imgshrink:main"
merge-to = "zcmds.cmds.common.merge_to:main"
removebackground = "zcmds.cmds.common.removebackground:main"
trash = "zcmds.cmds.common.trash:main"
push = "zcmds.cmds.common.push:main"
pull = "zcmds.cmds.common.pull:main"
gitconfigure = "zcmds.cmds.common.gitconfig:main"
new  = "zcmds.cmds.common.new:main"